11111111111111111111111111111111111111
1N000000000000000000000000000000000001
10000000000000000000000000000000000001
10000000000000000000000000000000000001
10000000000000000000000000000000000001
10000000000000000000000000000N00000001
10000000000000000000000000000000000001
10000000000000000000000000000000000001
10000000000000000000000000000000000001
10000000000000000000000000000000000001
10000100000000000000000000000000000001
10000010000000000000010000000000000001
10000101000000000000000000000000000001
100000001000000000000000000000100000001
10000000000000000000000000000000000001
10000000000000000000000000000000000001
10000000000000000000000110000000000001
10000000000000000000000000000000000001
10000000000000000000000000000000000001
10100000000000000000000000000000000001
10000000000000000000000000000000000001
10000000000000000000000000000000000001
10000000000000000000000000000000000001
10000000000000000000000000000000000001
10000000000000000000000000000000000001
10000000000000000000000000000000000001
10000000000000000000000000000000000001
10000000000000000000000000000000000001
11111111111111111111111111111111111011