SO textures/S.png
NO textures/N.png
EA textures/E.png
WE textures/W.png

C 20,34,2
F 20,45,3


11111
11001
1N0101
111111