SO textures/S.png
NO textures/N.png
EA textures/E.png
WE textures/W.png

C 20,34,2
F 20,45,3


1111111111111111111111111
1000000000000000000000001
1000000000000000000000001
1000000000000000000000001
1000000000000000000000001
100000000000000000E000001
1000000000000000000000001
1000000000000000000000001
1111111111111111111111111
1000000000000000000000001
1000000000000000000000001
1000000000000000000000001
1000000000000000000000001
100000000000000000000001
1000000000000000000000001
1000000000000000000000001
N111111111111111111111111