SO textures/S.png
NO textures/N.png
EA textures/E.png
WE textures/W.png

C 20,45,112
F 20,45,12

11111111111111111111
11000000000000100001
10000000000000000101
10000000000000000011
100000000000000N0001
10000000000000000011
11111111111111111111