SO textures/S.png
NO textures/N.png
EA textures/E.png
WE textures/W.png


1111111111111111111111111
1000000000000000000000001
1000000000000000000000001
1000000000000000000000001
1000000000000000000100001
1111111111111111111111111
1000000000000000000000001
1111111111111111111111111
11111111111111111000001111111111111111111
                1000000000000000000000001
                1000000000000000000000001
                1000000000000000000000001
                1000000000000000000000001
                1000000000000000000000001
                1000000000000000000000001
                1000000011111111111000001
    1111111111111000000011111    1100000111111111111111111
    1000000000000000000000001    1000000000000000000000001
    1000000000000000000000001    1000000000000000000000001
    1000000000000000000000001    1000000000000000000000001
    1000000000000000000000001    1000000000000000000000001
    1000000000000000000000001    1111111111111111111111111
    1000000000000000000000001
    10000000000000000N0000001
    1111111111111111111111111