
SO textures/S.png
NO textures/N.png
EA textures/E.png
WE textures/E.png


C 20,45,12
F 20,45,12
                1111111111111111111111111
                1000000000000000000000001
                1000000000000000000000001
                1000000000000000000000001
                1000000000000000000000001
                1000000000000000000000001
                1000000000000000000000001
                1000000011111111111000001
    1111111111111000000011111    1100000111111111111111111
    1000000000000000000000001    1000000000000000000000001
    1000000000000000N00000001    1000000000000000000000001
    1000000000000000000000001    1000000000000000000000001
    1000000000000000000000001    1000000000000000000000001
    1000000000000000000000001    1111111111111111111111111
    1000000000000000000000001
    1000000000000000000000001
    1111111111111111111111111
